егленcелер	егленcе
сüргüнлікнің	сüргüнлік
монархійада	монархійа
кöстергенлері	кöстер
öксüз	öксüз
баğлай	баğла
баğлай	баğла
йапылыр	йап
йапылыр	йап
йапылыр	йапыл
йапылыр	йапыл
йапылыр	йап
йапылыр	йапыл
қарşылаşмақ	қарşылаş
çабік	çабік
меркезнің	меркез
аслында	аслында
санында	сан
тuтмақ	тuт
іşтіракçілері	іşтіракçі
сойады	сойады
фелсефесі	фелсефе
хатырлав	хатырла
хатырлав	хатырлав
таşлары	таş
йіпек	йіпек
йоқ	йоқ
йерлеşтірген	йерлеşтір
йерлеşтірген	йерлеşтір
йерлеşтірген	йерлеşтір
йерлеşтірген	йерлеşтір
векіллерінің	векіл
мuсафірлерні	мuсафір
басмаханеде	басмахане
üкüметінің	üкüмет
дереcесі	дереcе
деврінде	девір
меселені	меселе
меселені	меселен
лагерге	лагер
şеерден	şеер
йuнанcа	йuнан
йuнанcа	йuнанcа
йuнанcа	йuнанcа
йе	йе
даğcы	даğcы
діаспорасында	діаспора
інстітuтының	інстітuт
майның	май
йазğанына	йаз
респuбліка	респuбліка
хітлер	хіт
борuçық	борuçық
uқuқçы	uқuқçы
доменге	домен
кіраз	кіраз
темсілcісі	темсілcі
давалаşмасында	давалаş
cенклер	cенк
бuйрuğына	бuйрuқ
балалайка	балалайка
фелсефесіні	фелсефе
тоқтав	тоқта
тоқтав	тоқтав
uзақлаşтырылğан	uзақлаşтыр
uзақлаşтырылğан	uзақлаşтыр
uзақлаşтырылğан	uзақлаşтыр
uзақлаşтырылğан	uзақлаşтыр
балықлар	балық
öлüмге	öлüм
бейнен	бей
сойuндан	сой
йардымcысына	йардымcы
қапалы	қапалы
таşтан	таş
ресімлер	ресімлер
ресімлер	ресім
істілâ	істілâ
üкüметі	üкüмет
йазğан	йаз
йазğан	йаз
йазğан	йаз
йазğан	йаз
етілüвінен	ет
етілüвінен	етіл
радасының	рада
мüтехассысы	мüтехассыс
зійалылар	зійалы
халіфені	халіфе
лâтіфелер	лâтіфе
фаалійетіні	фаалійет
бöлüнüв	бöл
бöлüнüв	бöлüнüв
сuвğа	сuв
іşарет	іşарет
сüлâлесіне	сüлâле
діректоры	діректор
мобілізатсійа	мобілізатсійа
тайфасы	тайфа
аскерлерінен	аскер
радіосына	радіо
кöтерілüві	кöтер
меденійеті	меденійет
мараз	мараз
şаіріміз	şаір
öмüрқардаşы	öмüрқардаşы
öмüрқардаşы	öмüрқардаşы
беşерійетінің	беşерійет
терріторійаларына	терріторійа
ібадетханесінің	ібадетхане
қапатылды	қапат
контсертінде	контсерт
васійеті	васійет
арнавuтлық	арнавuтлық
тарафларындан	тараф
векіллері	векіл
ескі	ескі
uсuлның	uсuл
йат	йат
йат	йад
бірлігінден	бірлік
філмден	філм
пайтахтында	пайтахт
қuрuлыşлар	қuрuлыş
каналы	канал
сақынып	сақын
сақынып	сақын
інсанның	інсан
майоры	майор
сöзüнің	сöз
таcікçе	таcік
таcікçе	таcікçе
таcікçе	таcікçе
іcаткâрлардан	іcаткâр
меркезіне	меркез
османлылар	османлы
бöлме	бöл
бöлме	бöл
бöлме	бöлме
қыдырмаğа	қыдыр
емін	емін
вақіаларына	вақіа
коллектівізатсійа	коллектівізатсійа
файдаланды	файдалан
клuбuнда	клuб
парламентке	парламент
іşіткенімден	еşіт
öгге	öг
грuппадан	грuппа
ойнады	ойна
тuта	тuт
тuта	тuт
харітасыны	харіта
файдаланылыр	файдалан
файдаланылыр	файдалан
файдаланылыр	файдалан
тіллеріне	тіл
мuсафірнің	мuсафір
категорійаларда	категорійа
uçаğыны	uçақ
uйездінің	uйезд
тасілінің	тасіл
uçаққа	uçақ
uрuşтан	uрuş
кâінат	кâінат
алманcа	алман
алманcа	алманcа
алманcа	алманcа
мімарій	мімарій
тенқіт	тенқіт
сықыşтырылğан	сықыşтыр
сықыşтырылğан	сықыşтыр
сықыşтырылğан	сықыşтыр
сықыşтырылğан	сықыşтыр
майор	майор
сенелерден	сене
çалмаздан	çал
фырсат	фырсат
мuаллімі	мuаллім
пійаноğа	пійано
сайты	сайт
классікі	классік
бірлеşмесіне	бірлеş
бірлеşмесіне	бірлеşме
обйектів	обйектів
тüркü	тüрк
тüркü	тüркü
тüркü	тüрк
тüркü	тüрк
тüркü	тüркü
мейданлыққа	мейданлық
кітапханенің	кітапхане
мüдірі	мüдір
оğланны	оğлан
таşламақ	таşла
діссертатсійасы	діссертатсійа
тuрізмден	тuрізм
öлüмінің	öлüм
океанларына	океан
басыла	бас
басыла	бас
інсанійетлік	інсанійетлік
тедавійленген	тедавійлен
тедавійленген	тедавійлен
тедавійленген	тедавійлен
тедавійленген	тедавійлен
албомы	албом
мемuарлар	мемuарлар
контрол	контрол
айта	айт
айта	айт
еттірмек	еттір
çеккенлерінден	çек
океандан	океан
османлыcа	османлы
мüддеттен	мüддет
кедер	кедер
çевірмеге	çевір
йаşлықның	йаşлық
батыл	бат
бuлuнğаныны	бuлuн
мевзuларынен	мевзu
сахрасы	сахра
беcеріклі	беcеріклі
cедвелні	cедвел
балаларны	бала
üстüне	üст
евден	ев
зuлüм	зuлüм
мuнасебетлер	мuнасебет
баşында	баş
оğраşқаны	оğра
йапылмаз	йап
йапылмаз	йапыл
йапылмаз	йап
йапылмаз	йапыл
кöтермек	кöтер
оптікій	оптікій
тақіқатçы	тақіқатçы
дерсліклеріні	дерслік
фізіка	фізіка
йолбаşçылыğының	йолбаşçылық
селâмым	селâм
баба	баба
іман	іман
гемісі	гемі
парламентінен	парламент
беген	беген
іşğал	іşğал
аçыла	аç
аçыла	аç
еттірілді	еттір
заводлары	завод
органларğа	орган
асылзаделер	асылзаде
евлеріне	ев
хucuр	хucuр
нüмüнелеріні	нüмüне
сайланалар	сайла
дестанларындан	дестан
діпломыны	діплом
қабілесінің	қабіле
uран	uран
üкüметлерінің	üкüмет
і̇нстітuты	інстітuт
телüкесінен	телüке
газетасыны	газета
бітмесінен	біт
міллетімізні	міллет
йарымадаğа	йарымада
і̇клімі	іклім
намы	нам
технікuмы	технікuм
cеннетіне	cеннет
олuнмақ	ол
мüессісе	мüессісе
қuлланылаcақ	қuллан
қuлланылаcақ	қuллан
қuлланылаcақ	қuллан
қuйuларына	қuйu
еліфбесі	еліфбе
табіатының	табіат
ікâйелерінде	ікâйе
қuветлері	қuвет
категотійасында	категотійа
доğрuдан	доğрuдан
мuдафаасына	мuдафаа
çайпамақ	çайпа
імкâны	імкâн
тертіп	тертіп
вазіфелерінде	вазіфе
олмаğаны	ол
іссі	іссі
сüлâлелер	сüлâле
басымы	басым
лейтенанты	лейтенант
сuвны	сuв
зuлuмğа	зuлuм
şекілленüвінен	şекіллен
қабілелер	қабіле
йевроның	йевро
етім	ет
cылт	cылт
оğuл	оğuл
кüçüні	кüç
контакт	контакт
ватанымызда	ватан
мезарына	мезар
топрақларğа	топрақ
öткеріcі	öткер
матеріаллар	матеріал
кеçмейcек	кеç
кеçмейcек	кеç
кеçмейcек	кеç
сыныфта	сыныф
зійаретіне	зійарет
олмасының	ол
деніле	деніл
деніле	деніл
неşрійатта	неşрійат
cіан	cіан
оқuй	оқu
оқuй	оқu
даğлық	даğлық
радіосы	радіо
кетірмеге	кетір
ілванлар	ілван
генçлеріні	генç
ісімге	ісім
оğраşқан	оğра
оğраşқан	оğра
оğраşқан	оğра
оğраşқан	оğра
кöрмегені	кöр
терcіме	терcіме
вазійетнің	вазійет
сüлâлелерні	сüлâле
бақасың	бақ
öсмüрлерні	öсмüр
олаcақ	ол
олаcақ	ол
олаcақ	ол
батқандан	бат
йаратылып	йарат
йаратылып	йарат
парçалар	парçа
қоşuлып	қоş
қоşuлып	қоş
намuс	намuс
корейалылар	корейалы
терcіман	терcіман
аілесінден	аіле
мüхбір	мüхбір
нақлій	нақлій
генçлікке	генçлік
мектüплеşе	мектüплеş
мектüплеşе	мектüплеş
йолақ	йолақ
пйесаларыны	пйеса
профессорлардан	профессор
баар	баар
теşеккüл	теşеккüл
міллетçілік	міллетçілік
мектüплер	мектüп
üйле	üйле
çевірілгенден	çевір
теңеşтірем	теңеşтір
сесіні	сес
тöпесі	тöпе
тöпесі	тöпесі
қалемі	қалем
ханенің	хане
байрамларда	байрам
тuвğанлары	тuв
тuвğанлары	тuвğан
сійасетçісі	сійасетçі
реіслігіні	реіслік
емрінен	емір
кіşінен	кіşі
октâбр	октâбр
еттірмеге	еттір
сüргüнлікке	сüргüнлік
оcаларğа	оcа
болşевіклер	болşевік
кеçкен	кеç
кеçкен	кеç
кеçкен	кеç
кеçкен	кеç
маcарcа	маcар
öтмек	öтмек
інстітuтларда	інстітuт
кöстеріş	кöстер
қuрма	қuр
қuрма	қuр
кöşеге	кöşе
орманы	орман
кöйдеşлеріне	кöйдеş
мuкâфатнен	мuкâфат
евлерде	ев
тақіқатçылары	тақіқатçы
қамаçавда	қамаçав
дернегі	дернек
іcраcының	іcраcы
парламент	парламент
öлдüрген	öлдüр
öлдüрген	öлдüр
öлдüрген	öлдüрген
öлдüрген	öлдüр
öлдüрген	öлдüр
кергінлеşе	кергінлеş
кергінлеşе	кергінлеş
корuма	кор
корuма	корu
корuма	корu
бöлüктен	бöлüк
оқuлğан	оқu
оқuлğан	оқu
оқuлğан	оқu
оқuлğан	оқu
мевқі	мевқі
йоллай	йолла
йоллай	йолла
йаşамай	йаşа
йаşамай	йаşа
теркіп	теркіп
біналарынен	біна
інстітuтыны	інстітuт
текрар	текрар
текрар	текрар
кеçірірлер	кеçір
себепçі	себепçі
адландырыла	адландыр
адландырыла	адландыр
алтына	алт
балавuз	балавuз
ілімнің	іл
ілімнің	ілім
йасақланğан	йасақлан
йасақланğан	йасақлан
йасақланğан	йасақлан
йасақланğан	йасақлан
авалесінен	авале
комітетлері	комітет
бірлеşтіріп	бірлеşтір
бірлеşтіріп	бірлеşтір
топçu	топçu
йаşайыşы	йаşайыş
раатланмақ	раатлан
кüл	кüл
кüл	кüл
доğuрыр	доğuр
доğuрыр	доğuр
доğuрыр	доğuр
тамырдан	тамыр
районларында	район
теренлігіне	теренлік
қытаның	қыта
ортақ	ортақ
şеадетнамесі	şеадетнаме
ортақлаşа	ортақлаş
ортақлаşа	ортақлаş
қайтарğан	қайтар
қайтарğан	қайтар
қайтарğан	қайтар
қайтарğан	қайтар
гuбернійаларына	гuбернійа
қойu	қой
океанларğа	океан
вокзалы	вокзал
тuрмuşы	тuрмuş
бüйüк	бüйüк
меркезінде	меркез
кüндоğuş	кüндоğuş
тарафларны	тараф
зарардан	зарар
оğuллары	оğuл
қалынлыğы	қалынлық
інанылğан	інан
інанылğан	інан
інанылğан	інан
інанылğан	інан
топлаğан	топла
топлаğан	топла
топлаğан	топла
топлаğан	топла
öлü	öлü
егленірлер	еглен
йалыларыны	йалы
арареті	арарет
сілінділер	сіл
йеріне	йер
каталог	каталог
ідаре	ідаре
йайынында	йайын
бüйüклікке	бüйüклік
дерсі	дерс
темсілcілігінен	темсілcілік
термінологійа	термінологійа
евлійа	евлійа
ücüмге	ücüм
інсанларны	інсан
еттірді	еттір
маддій	маддій
қuсuрлары	қuсuр
елйазма	елйазма
қuтuбы	қuтuп
çöллерінде	çöл
стратегік	стратегік
аваның	ава
аваның	аван
қатында	қат
етілділер	ет
етілділер	етіл
қонuşқан	қон
қонuşқан	қон
қонuşқан	қонuş
қонuşқан	қонuş
қонuşқан	қон
қонuşқан	қонuş
қонuşқан	қон
қонuşқан	қонuş
мuзыкасы	мuзыка
сыңырындан	сыңыр
аталар	ат
аталар	ата
аст	аст
uнuтмайарақ	uнuт
сессійасында	сессійа
соқақтан	соқақ
şеффаф	şеффаф
прокuратuрасында	прокuратuра
зан	зан
меркезіні	меркез
протсесс	протсесс
қырымçақлар	қырымçақ
сыğмаз	сыğ
сыğмаз	сыğ
діл	діл
сыçрама	сыçра
сыçрама	сыçра
ісвіçрелі	ісвіçрелі
üмüт	üмüт
şіірлерінде	şіір
намuсымыз	намuс
фірмасында	фірма
uсталықны	uсталық
оğраşқанларның	оğра
тuтқаны	тuт
йыл	йыл
девір	девір
девір	девір
бuлuныр	бuлuн
бuлuныр	бuлuн
бuлuныр	бuлuн
қавімлерінің	қавім
асылзаделерні	асылзаде
öзенде	öзен
стuденті	стuдент
şарқның	şарқ
кеçер	кеç
кеçер	кеç
кеçер	кеç
тақдіріне	тақдір
сыңыр	сыңыр
йанаşмадылар	йанаş
міллетлер	міллет
ендесе	ендесе
қыпçақ	қыпçақ
йерде	йер
бöреклер	бöрек
бuйрuқ	бuйрuқ
сöзлерде	сöз
çеçек	çеçек
грівна	грівна
терен	терен
тамірі	тамір
қuрşuн	қuрşuн
вucuтны	вucuт
мuқавелесі	мuқавеле
йана	йан
йана	йан
мuкâфатында	мuкâфат
адамлары	адам
cемаатқа	cемаат
cіварына	cівар
сейірcілеріні	сейірcі
етілüв	ет
етілüв	етіл
пйесалардан	пйеса
таşлайcаğыны	таşла
інтернетте	інтернет
üрметке	üрмет
адій	адій
сüннійлік	сüннійлік
мектеплерде	мектеп
намзеті	намзет
кöşе	кöşе
бірлікте	бірлік
йüксеклігі	йüксеклік
емірлері	емір
çаğырылды	çаğыр
тöкüле	тöк
тöкüле	тöкüл
тöкüле	тöк
тöкüле	тöкüл
імзаланды	імзала
йылдызы	йылдыз
бейінің	бей
і̇рмақлар	ірмақ
повестіні	повест
севдалық	севдалық
қамере	қамере
йазылары	йазы
і̇слâмда	і̇слâм
і̇слâмда	іслâм
uсuлларына	uсuл
білірсіңіз	біл
істеген	істе
істеген	істе
істеген	істе
істеген	істе
азат	азат
фаалійетінен	фаалійет
есасланып	есаслан
есасланып	есаслан
сöзüні	сöз
нетіcеленген	нетіcелен
нетіcеленген	нетіcелен
нетіcеленген	нетіcелен
нетіcеленген	нетіcелен
сарайларында	сарай
нетіcесіне	нетіcе
дuаларны	дuа
романларыны	роман
öглерінде	öг
қалем	қале
қалем	қалем
йатты	йат
фінанс	фінанс
şаşырğан	şаşыр
şаşырğан	şаşыр
şаşырğан	şаşырğан
şаşырğан	şаşыр
şаşырğан	şаşыр
планлаşтырğан	планлаşтыр
планлаşтырğан	планлаşтыр
планлаşтырğан	планлаşтыр
планлаşтырğан	планлаşтыр
імкâныны	імкâн
повест	повест
бірлік	бірлік
меcмuасына	меcмuа
сыcақ	сыcақ
ом	ом
бабамның	баба
албомның	албом
сüргüнлігінің	сüргüнлік
қалеміні	қалем
сенелік	сенелік
бостанcы	бостанcы
себеплерінден	себеп
хызметлер	хызмет
қадынлардан	қадын
фаşіст	фаşіст
оğраşмай	оğра
оğраşмай	оğра
дернек	дернек
мüітнің	мüіт
хазіне	хазіне
қызларына	қыз
вақтынcа	вақыт
вақтынcа	вақтынcа
йетті	йет
şей	şей
сайламаğа	сайла
дегерінің	дегер
дерслік	дерслік
қавім	қавім
мuзыкасының	мuзыка
есасланğан	есаслан
есасланğан	есаслан
есасланğан	есаслан
есасланğан	есаслан
cемійетлерні	cемійет
пайтахтынен	пайтахт
намзетлері	намзет
қысымлардан	қысым
вазгеçмекні	вазгеç
іcретçілерні	іcретçі
севіп	сев
севіп	сев
телеканалы	телеканал
дест	дест
мірасçысы	мірасçы
істей	істе
істей	істе
мüддетіне	мüддет
тақдімі	тақдім
сuіқастнен	сuіқаст
гала	гала
меденій	меденій
şаірлері	şаір
сійасетіні	сійасет
вефатының	вефат
қuрu	қuрu
мейва	мейва
сеййаресі	сеййаре
мейданы	мейдан
мерақ	мерақ
оğuрлы	оğuрлы
неşе	неşе
кітапларыны	кітап
тапылмаğанындан	тап
şіірінде	şіір
оcаларнен	оcа
şіірійеті	şіірійет
бойсuнuв	бойсuн
азырланğан	азырла
азырланğан	азырла
азырланğан	азырла
азырланğан	азырла
қытасы	қыта
çіл	çіл
бербат	бербат
ебедійлеşтірді	ебедійлеşтір
ханымда	хан
рuсларğа	рuс
йоллап	йолла
йоллап	йолла
оң	оң
кöрüşмек	кöр
қар	қар
дінінден	дін
сабасына	саба
ібарелернің	ібаре
сейран	сейран
çеşітлері	çеşіт
марuзанен	марuза
себебі	себеп
кетірілüвінің	кетір
федератсійасы	федератсійа
çаğырuв	çаğыр
білмесі	біл
қайтарылмады	қайтар
şüбе	şüбе
қаве	қаве
хuрафат	хuрафат
аса	аса
йерлеşüві	йерлеş
назір	назір
йетіşкен	йет
йетіşкен	йет
йетіşкен	йетіşкен
йетіşкен	йет
йетіşкен	йет
баğларыны	баğ
баğларыны	баğлар
йолбаşçымыз	йолбаşçы
талапларына	талап
етерек	ет
йарарлықлары	йарарлық
кüреşте	кüреş
сöзлері	сöз
йаşай	йаşа
йаşай	йаşа
заманлар	заман
қазанç	қазанç
cемійетлері	cемійет
баğçасы	баğçа
йазылмақта	йаз
кöстерілген	кöстер
кöстерілген	кöстер
кöстерілген	кöстер
кöстерілген	кöстер
форматында	формат
менсüп	менсüп
кöлемде	кöлем
сімволлары	сімвол
гüрделі	гüрделі
османлыларğа	османлы
лексікасының	лексіка
йаңылықлар	йаңылық
мuстақіллігіні	мuстақіллік
қардаşларыма	қардаş
кірмеге	кір
öлдüріп	öлдüр
öлдüріп	öлдüр
қалелеріні	қале
вазіфесі	вазіфе
топланмасынен	топла
кüркçüлер	кüркçü
кüтлевійлеşтірілмесі	кüтлевійлеşтір
ренкте	ренк
кöйлеріні	кöй
іcретнің	іcрет
вірüс	вірüс
şівесі	şіве
етіңіз	ет
етіңіз	ет
істіқаметте	істіқамет
деде	деде
незарет	незарет
реісі	реіс
мемuрларның	мемuр
қuртuлды	қuртuл
сарфы	сарф
білгенлернің	біл
реісіні	реіс
кірсетілмеген	кірсет
кірсетілмеген	кірсет
кірсетілмеген	кірсет
кірсетілмеген	кірсет
естетіка	естетіка
ханыны	хан
доğuв	доğ
ğыйабій	ğыйабій
варіантларда	варіант
махсuллар	махсuл
коміссійа	коміссійа
олuна	ол
олuна	ол
çырмавuқ	çырмавuқ
акімійеті	акімійет
тіллері	тіл
хорлuқтан	хорлuқ
еткенлеріні	ет
дерсліклерде	дерслік
йолuны	йол
радасына	рада
мезарларының	мезар
сақланмасы	сақла
інсанлыққа	інсанлық
сеферлерге	сефер
cіварында	cівар
üлкеде	üлке
орманда	орман
қайаның	қайа
тuтuлğан	тuт
тuтuлğан	тuт
тuтuлğан	тuтuл
тuтuлğан	тuтuл
тuтuлğан	тuт
тuтuлğан	тuтuл
тuтuлğан	тuт
тuтuлğан	тuтuл
йараланып	йаралан
йараланып	йаралан
фырқаның	фырқа
мыşық	мыşық
дüнйа	дüнйа
ікâйелерінің	ікâйе
оператсійасы	оператсійа
öйле	öйле
öйле	öйле
дuşманлық	дuşманлық
аскерлерге	аскер
білінген	біл
білінген	біл
білінген	біл
білінген	біл
клuбның	клuб
қысқартылğан	қысқартылğан
малік	малік
дінлер	дін
білдірілген	білдір
білдірілген	білдір
білдірілген	білдір
білдірілген	білдір
еалілеріне	еалі
қанuнларğа	қанuн
йаşамаğа	йаşа
çалыşмаларğа	çал
çалыşмаларğа	çалыş
едебійат	едебійат
ейкелтраş	ейкелтраş
амерікан	амерікан
еййет	еййет
cемааты	cемаат
вақіаны	вақіа
сайлана	сайла
сайлана	сайла
қаçарақ	қаç
çалыşмаğа	çал
çалыşмаğа	çалыş
üмüтлерге	üмüт
боğазы	боğаз
кесілмесінің	кесіл
даğлары	даğ
соңра	соңра
бестекâрлар	бестекâр
кöçкенлернің	кöç
тынuвындан	тын
ерік	ерік
темеліні	темел
міллій	міллій
технік	технік
қабілелерні	қабіле
даветінен	давет
тесірі	тесір
кüлкüнçлі	кüлкüнçлі
бойларында	бой
бой	бой
радіосындан	радіо
uзuнлықларда	uзuнлық
папазы	папаз
оқuвны	оқu
оқuвны	оқuв
йазысы	йазы
кöçмек	кöç
меденійетні	меденійет
балалыğы	балалық
хораз	хораз
олğаныны	ол
стратегійаны	стратегійа
çuваşлар	çuваş
сüтü	сüт
қалесіні	қале
öлüмден	öлü
öлüмден	öлüм
şаірлеріне	şаір
йанды	йан
сайлавларның	сайла
сайлавларның	сайлав
şақаларны	şақа
çықарğанлар	çықар
çықарğанлар	çықар
öсüв	öс
татарларындан	татар
тамğалары	тамğа
şіірден	şіір
йырларыны	йыр
тантаналар	тантана
мааріфі	мааріф
діректор	діректор
депuтатлардан	депuтат
соқаğы	соқақ
şеерінің	şеер
назарійесінің	назарійе
сайлавлары	сайла
сайлавлары	сайлав
пройектлеріне	пройект
кооператсійасы	кооператсійа
мабет	мабет
тефтіş	тефтіş
тuccарына	тuccар
ітаатында	ітаат
сарайğа	сарай
şанына	şан
літсейде	літсей
відео	відео
вақіалар	вақіа
топрақларында	топрақ
йерлеşтік	йерлеş
йерлеşтік	йерлеş
і̇кâйелер	ікâйе
теңеşтірілген	теңеşтір
теңеşтірілген	теңеşтір
теңеşтірілген	теңеşтір
теңеşтірілген	теңеşтір
іşке	іş
кâğыт	кâğыт
қытасының	қыта
üслüплернің	üслüп
статuсына	статuс
газетасында	газета
şеерлерге	şеер
файдаланылды	файдалан
аллы-тақатлы	аллы-тақатлы
öгренілгені	öгрен
кезінті	кезінті
етілгенінің	ет
етілгенінің	етіл
cенкке	cенк
ортодокс	ортодокс
аіледе	аіле
фuртuна	фuртuна
лuğатлар	лuğат
қараманлары	қараман
теşкілâтларның	теşкілâт
öткерген	öткер
öткерген	öткер
öткерген	öткер
öткерген	öткер
діңлегенде	діңле
қоşмалар	қоş
қанuнлар	қанuн
şіарлар	şіар
uрuşлары	uрuş
еткенлеріне	ет
малы	мал
невбетлеşме	невбетлеş
невбетлеşме	невбетлеş
есірлікте	есірлік
темсіл	темсіл
кіріşті	кір
кіріşті	кіріş
йарымадасы	йарымада
маcар	маcар
босаğаларының	босаğа
стuдентлер	стuдент
імзаламаğа	імзала
üст	üст
мебuс	мебuс
сüлâлелерден	сüлâле
йақынлық	йақынлық
тікленüві	тікле
тікленüві	тіклен
хан	хан
çықарылмасында	çықар
тедавійленмек	тедавійлен
назарыны	назар
қазақларнен	қазақ
мüневерлерінің	мüневер
мüневерлерінің	мüневерлер
cuмхuрійетлерінден	cuмхuрійет
хайалларыны	хайал
йерлернің	йер
деңізінде	деңіз
хuбuбат	хuбuбат
телüкесізлікнің	телüкесізлік
телâффuзы	телâффuз
şіркетлері	şіркет
сарымында	сарым
себебіні	себеп
ес	ес
мемuрларны	мемuр
аğлама	аğла
аğлама	аğла
консерва	консерва
емінлікнен	емінлік
емінлікнен	емінлікнен
ексіле	ексіл
ексіле	ексіл
констрuктсійа	констрuктсійа
uрuşқан	uр
uрuşқан	uр
uрuşқан	uрuş
uрuşқан	uрuş
uрuşқан	uр
uрuşқан	uрuş
uрuşқан	uр
uрuşқан	uрuş
пеşін	пеşін
міллетімізнің	міллет
қапатылğан	қапат
қапатылğан	қапат
қапатылğан	қапат
қапатылğан	қапат
кöреcек	кöр
кöреcек	кöр
кöреcек	кöр
қапатты	қапат
діній	діній
еşіткен	еşіт
еşіткен	еşіт
еşіткен	еşіт
еşіткен	еşіт
меcбuрій	меcбuрій
ханларына	хан
донu	дон
бізнесі	бізнес
йеңіліп	йең
йеңіліп	йең
çевресіне	çевре
қuралар	қuр
дінлерінің	дін
назірлер	назір
парçаларны	парçа
хызметлерде	хызмет
қардаş	қардаş
соңuнен	соң
соңuнен	соңu
йалысындан	йалы
сатылыр	сат
сатылыр	сат
сатылыр	сатыл
сатылыр	сатыл
сатылыр	сат
сатылыр	сатыл
серлевасынен	серлева
кöйлерінден	кöй
регіонларында	регіон
етмекте	ет
етмекте	ет
сене	сене
орбіта	орбіта
фааллік	фааллік
мезарыны	мезар
ікліміне	іклім
грuппасындан	грuппа
марşрuты	марşрuт
ілк	ілк
мавы	мавы
блок	блок
бергіден	бергі
қавuşмаğа	қавuş
профессор	профессор
кöзге	кöз
танылды	таны
танылды	таныл
іхтісасының	іхтісас
евлерінден	ев
меркез	меркез
cемійетлернің	cемійет
азалары	аза
рессамы	рессам
сüлâлелернің	сüлâле
вақытларында	вақыт
атылмақ	ат
йетіşмей	йет
йетіşмей	йет
презідентінің	презідент
сöндüрмемеге	сöндüр
сейаатлар	сейаат
файдаланыла	файдалан
файдаланыла	файдалан
прокuратuрасыны	прокuратuра
оğрады	оğра
мадделернің	мадде
тарлық	тарлық
районына	район
геcелернен	геcе
баğçаларда	баğçа
ілімге	ілім
радіода	радіо
қырал	қырал
еййетінің	еййет
азам	аза
назарына	назар
кереклігіне	кереклік
оcақларында	оcақ
қарыşuв	қарыş
кöстермек	кöстер
етмелері	ет
қоşuлмаса	қоş
қоşuлмаса	қоş
кuрсқа	кuрс
зійалылары	зійалы
мемuрій	мемuрій
дüлгері	дüлгер
базыда	базыда
даğcының	даğcы
зенгінлеşе	зенгінлеş
зенгінлеşе	зенгінлеş
қырымтатарcаğа	қырымтатарcа
давасыны	дава
оқuğан	оқu
оқuğан	оқu
оқuğан	оқu
оқuğан	оқu
собор	собор
беклейлер	бекле
вілâйетінде	вілâйет
ідарені	ідаре
сüйрü	сüйрü
кересінде	кере
хuсuсларыны	хuсuс
мuсафірлікке	мuсафірлік
йардымлаşuв	йардымлаş
мüтеşем	мüтеşем
тесірлері	тесір
халқ	халқ
йазар	йазар
лейхалар	лейха
іşтіракçілерінден	іşтіракçі
абіделерінден	абіде
девлетçілігінің	девлетçілік
теcрібесіні	теcрібе
йақты	йақ
грuппаларда	грuппа
juрналістлер	juрналіст
тахталар	тахта
сентâбрден	сентâбр
üкüметлеріні	üкüмет
хадімі	хадім
теşеббüс	теşеббüс
тарафынен	тараф
адвокат	адвокат
аşк	аşк
седасы	седа
декабр	декабр
öг	öг
баğçада	баğçа
істілâсыны	істілâ
бuзқыран	бuзқыран
балықçылар	балықçы
сатып	сат
сатып	сат
парламентінің	парламент
марşрuт	марşрuт
авuç	авuç
йалдызлы	йалдызлы
фырқасына	фырқа
şарқта	şарқ
фuртuналар	фuртuна
uніверсітет	uніверсітет
дuдаğынен	дuдақ
беклемекте	бекле
беклемекте	бекле
ğайелері	ğайе
деген	де
деген	де
деген	де
деген	де
діққат	діққат
зыддійет	зыддійет
еслетме	еслетме
ойuнларыны	ойuн
еліне	ел
мектеплерінде	мектеп
фабрікасыны	фабріка
татарым	татар
беледійе	беледійе
тақыр	тақыр
і̇лк	ілк
сеферні	сефер
ноğайğа	ноğай
манзuм	манзuм
çалыşuвынен	çал
çалыşuвынен	çалыş
давuлы	давuл
кöçмесіне	кöç
граjдан	граjдан
граjдан	граjдан
ікâйеcісі	ікâйеcі
jандармерійада	jандармерійа
баğ	баğ
cенкінің	cенк
інşааты	інşаат
істідат	істідат
бöлüм	бöлüм
італійалылар	італійалы
меркезге	меркез
йерлеріне	йер
іслâм	іслâм
тахтқа	тахт
мuнасебетлернің	мuнасебет
йете	йет
йете	йет
тüркüнде	тüрк
тіклеп	тікле
тіклеп	тікле
cінайетлернің	cінайет
факuлтетінде	факuлтет
маніфест	маніфест
